1 1 1 1
1 0 4 1
1 4 0 1
1 2 3 1
1 3 0 1
1 1 1 1