0 0 1 1 1 1 0 0
1 1 1 0 3 1 1 1
1 4 0 3 0 5 0 1
1 0 4 2 6 0 5 1
1 1 1 6 0 1 1 1
0 0 1 1 1 1 0 0